...C...............
...................
.F.....P....A......
...................
...F....EE.........
...................
................F..
.......S...........
...................
...#########.......
...................
...................
...................